* *******************
* *   *     *       *
* * *** *** * * *** *
* *       *   *   * *
* * * *********** * *
* * *         *   * *
* *** * * *** * *** *
*     * *   * *   * *
* ***** *** * * * ***
* *   * * * * * *   *
* *** * * * * ***** *
*     * *   *       *
* * *** *********** *
* *   *   *   *     *
* *** *** * * * *****
* * *   * * * *     *
* * *** * *** ***** *
* *     *     * *   *
* ************* * ***
*               *    
*********************